#domain
hospital
#levelname
MAchallenge
#colors
blue: 0, 1, 2, 3, A, E, F, J, K, L
#initial
++++++++++++++++++++++++
+                  A   +
+       +++   ++       +
+       ++++++++       +
+                      +
+   J 1          0     +
+   K 2 ++++++++   E   +
+   L 3            F   +
++++++++++++++++++++++++
#goal
++++++++++++++++++++++++
+ A                    +
+       +++   ++       +
+       ++++++++       +
+                      +
+                    J +
+ E     ++++++++     K +
+ F                  L +
++++++++++++++++++++++++
#end
