#domain
hospital
#levelname
MA_Blocking
#colors
blue: 0, 1, A
red: 2, B
#initial
++++++++++++++
+           0+
+            +
+B+          +
+1+A         +
+2+          +
++++++++++++++
#goal
++++++++++++++
+            +
+            +
+ +          +
+ +          +
+ +A         +
++++++++++++++
#end
