#domain
hospital
#levelname
MA_Blocking
#colors
red: 0, A, B, C
blue: 1, D, E, F
cyan: 2, G, H, I
pink: 3, J, K, L
grey: 4, M, N, O
green: 5, P, Q, R
brown: 6, S, T, U
purple:7, V, X, Y
orange: 8, Z
lightblue: 9
#initial
++++++++++++++++++++++++++++++++++++++++++++++++++
+0ABC                                        1DEF+
+                                                +
+                                                +
+                                                +
+                                                +
+            2GHI                3JKL            +
+                                                +
+                                                +
+                                                +
+                                                +
+                                                +
+                                                +
+                                                +
+                                                +
+                                                +
+                                                +
+                                                +
+                                                +
+                                                +
+                                                +
+ 4MNO                                           +
+                                                +
+                                                +
+                                                +
+                                                +
+                                                +
+                                    5PQR        +
+                                                +
+                                                +
+                                                +
+                                                +
+                                                +
+                                                +
+      6STU                                      +
+                                                +
+                                                +
+                                                +
+                                                +
+                                                +
+                                                +
+                                                +
+                               7VXY             +
+                                                +
+                                                +
+                                                +
+    8Z                                          +
+                                                +
+                                                +
+                                            9   +
++++++++++++++++++++++++++++++++++++++++++++++++++
#goal
++++++++++++++++++++++++++++++++++++++++++++++++++
+                                                +
+                                                +
+                                                +
+                    6STU                        +
+                                                +
+                           3JKL                 +
+                                                +
+                                                +
+                                                +
+        9                                       +
+                                                +
+                                                +
+                                                +
+                                                +
+                   7VXY                         +
+                                                +
+                                                +
+                                                +
+                                                +
+                                                +
+                                                +
+                                                +
+               8Z                               +
+                                                +
+                                                +
+                                                +
+                                                +
+                                                +
+                                                +
+ 2GHI                                           +
+                                                +
+                                                +
+                                                +
+                                                +
+                                                +
+    1DEF                  0ABC                  +
+                                                +
+                                                +
+                                                +
+                                                +
+                                                +
+                                                +
+         5PQR                                   +
+                                                +
+                                                +
+                                                +
+                           4MNO                 +
+                                                +
+                                                +
++++++++++++++++++++++++++++++++++++++++++++++++++
#end
