#domain
hospital
#levelname
MAsimple5
#colors
blue: 0, 1, A
red: 2, B
#initial
+++++++++++++++
+      B0  A  +
+      B      +
+      B      +
+      BBBBBBB+
+            A+
+          1+++
+           A2+
+++++++++++++++
#goal
+++++++++++++++
+A           A+
+             +
+             +
+             +
+             +
+           +++
+           A +
+++++++++++++++
#end
