#domain
hospital
#levelname
MAPF00
#colors
blue: 0,1,2,3,4,5
#initial
+++++++++++++
+0 2        +
+1      4++++
+3       5  +
+        ++ +
+         + +
+++++++++++++
#goal
+++++++++++++
+          1+
+4       ++++
+           +
+        ++5+
+ 2      3+0+
+++++++++++++
#end
