#domain
hospital
#levelname
MAchallenge
#colors
blue: 0, 1, 2, 3, A, E, F, J, K, L
#initial
++++++++++++++++++++++++
+ A                    +
+       +++   ++       +
+       ++++++++     1 +
+                    J +
+    0             3L  +
+       ++++++++   E2K +
+                  F   +
++++++++++++++++++++++++
#goal
++++++++++++++++++++++++
+ A                    +
+       +++   ++       +
+       ++++++++       +
+                      +
+                    J +
+ E     ++++++++     K +
+ F                  L +
++++++++++++++++++++++++
#end
