#domain
hospital
#levelname
rip
#colors
blue: 0,1,2,3,4,5,6,R,I,P,S,O,C,A,L,F,E
#initial
+++++++++++++++++++++++++++++++++++++++++++++++++
+    0145                                       +
+++++++++++++++++++++++++++++++++++++++++++++++ +
+                                             + +
+ +++++++++++++++++++++++++++++++++++++++++++ + +
+ +                                         + + +
+ + +++++++++++++++++++++++++++++++++++++++ + + +
+ + +                                     + + + +
+ + + +++++++++++++++++++++++++++++++++++ + + + +
+ + + +                                 + + + + +
+ + + + +++++++++++++++++++++++++++++++ + + + + +
+ + + + ++      +              +     ++ + + + + +
+ + + + ++     ++              ++    ++ + + + + +
+ + + + ++       +            +      ++ + + + + +
+ + + + ++        +          +       ++ + + + + +
+ + + + ++         +++++++++         ++ + + + + +
+ + + + ++        +++++++++++        ++ + + + + +
+ + + + ++       +++ O+++ O+++       ++ + + + + +
+ + + + ++      ++++ 2+++ 3++++      ++ + + + + +
+ + + + ++       +++++++++++++       ++ + + + + +
+ + + + ++        ++++ + ++++        ++ + + + + +
+ + + + ++        + +++++++ +        ++ + + + + +
+ + + + ++       +  + + + +  +       ++ + + + + +
+ + + + ++      +   + + + +   +      ++ + + + + +
+ + + + ++    ++               ++    ++ + + + + +
+ + + + ++     +               +     ++ + + + + +
+ + + + +  EFILLIACSIORP                + + + + +
+ + + + +++++++++++++++++++++++++++++++++ + + + +
+ + + +                                   + + + +
+ + + +++++++++++++++++++++++++++++++++++++ + + +
+ + +                                       + + +
+ + +++++++++++++++++++++++++++++++++++++++++ + +
+ +                                           + +
+ +++++++++++++++++++++++++++++++++++++++++++++ +
+                                               +
+++++++++++++++++++++++++++++++++++++++++++++++++
#goal
+++++++++++++++++++++++++++++++++++++++++++++++++
+                                               +
+++++++++++++++++++++++++++++++++++++++++++++++ +
+                                             + +
+ +++++++++++++++++++++++++++++++++++++++++++ + +
+ +                                         + + +
+ + +++++++++++++++++++++++++++++++++++++++ + + +
+ + +                                     + + + +
+ + + +++++++++++++++++++++++++++++++++++ + + + +
+ + + +                                 + + + + +
+ + + + +++++++++++++++++++++++++++++++ + + + + +
+ + + + ++      +              +     ++ + + + + +
+ + + + ++     ++              ++    ++ + + + + +
+ + + + ++       +            +      ++ + + + + +
+ + + + ++        +          +       ++ + + + + +
+ + + + ++         +++++++++         ++ + + + + +
+ + + + ++        +++++++++++        ++ + + + + +
+ + + + ++       +++  +++  +++       ++ + + + + +
+ + + + ++      ++++O +++O ++++      ++ + + + + +
+ + + + ++       +++++++++++++       ++ + + + + +
+ + + + ++        ++++ + ++++        ++ + + + + +
+ + + + ++        + +++++++ +        ++ + + + + +
+ + + + ++       +  +R+I+P+  +       ++ + + + + +
+ + + + ++      +   + + + +   +      ++ + + + + +
+ + + + ++    ++     SOCIAL    ++    ++ + + + + +
+ + + + ++     +      LIFE     +     ++ + + + + +
+ + + + +                               + + + + +
+ + + + +++++++++++++++++++++++++++++++++ + + + +
+ + + +                                   + + + +
+ + + +++++++++++++++++++++++++++++++++++++ + + +
+ + +                                       + + +
+ + +++++++++++++++++++++++++++++++++++++++++ + +
+ +                                           + +
+ +++++++++++++++++++++++++++++++++++++++++++++ +
+                                               +
+++++++++++++++++++++++++++++++++++++++++++++++++
#end
